Wearable Computing Project - CODEBOOK
=====================================

Introduction
------------

Here is a list of variables which are contained in the dataset which is created after running the contained R script.

Variable List
-------------

 subjID                         : Primary Key identifying subject
 actID                          : Activity Key identifying activity
 activity                       : Activity Description
 tBodyAcc-mean()-X              : Time Domain Signal of Body Accelation in X axis (Mean)
 tBodyAcc-mean()-Y              : Time Domain Signal of Body Accelation in Y axis (Mean)
 tBodyAcc-mean()-Z              : Time Domain Signal of Body Accelation in Z axis (Mean)
 tBodyAcc-std()-X               : Time Domain Signal of Body Accelation in X axis (Standard Deviation)
 tBodyAcc-std()-Y               : Time Domain Signal of Body Accelation in Y axis (Standard Deviation)
 tBodyAcc-std()-Z               : Time Domain Signal of Body Accelation in Z axis (Standard Deviation)
 tGravityAcc-mean()-X           : Time Domain Signal of Gravitational Accelation in X axis (Mean)
 tGravityAcc-mean()-Y           : Time Domain Signal of Gravitational Accelation in Y axis (Mean)
 tGravityAcc-mean()-Z           : Time Domain Signal of Gravitational Accelation in Z axis (Mean)
 tGravityAcc-std()-X            : Time Domain Signal of Gravitational Accelation in X axis (Standard Deviation)
 tGravityAcc-std()-Y            : Time Domain Signal of Gravitational Accelation in Y axis (Standard Deviation)
 tGravityAcc-std()-Z            : Time Domain Signal of Gravitational Accelation in Z axis (Standard Deviation)
 tBodyAccJerk-mean()-X          : Time Derived (Jerk) Body Accelation in X axis (Mean)
 tBodyAccJerk-mean()-Y          : Time Derived (Jerk) Body Accelation in Y axis (Mean)
 tBodyAccJerk-mean()-Z          : Time Derived (Jerk) Body Accelation in Z axis (Mean)
 tBodyAccJerk-std()-X           : Time Derived (Jerk) Body Accelation in X axis (Standard Deviation)
 tBodyAccJerk-std()-Y           : Time Derived (Jerk) Body Accelation in Y axis (Standard Deviation)
 tBodyAccJerk-std()-Z           : Time Derived (Jerk) Body Accelation in Z axis (Standard Deviation)
 tBodyGyro-mean()-X             : Time Domain Signal of Angular Velocity in X axis (Mean) 
 tBodyGyro-mean()-Y             : Time Domain Signal of Angular Velocity in Y axis (Mean)
 tBodyGyro-mean()-Z             : Time Domain Signal of Angular Velocity in Z axis (Mean)
 tBodyGyro-std()-X              : Time Domain Signal of Angular Velocity in X axis (Standard Deviation)
 tBodyGyro-std()-Y              : Time Domain Signal of Angular Velocity in Y axis (Standard Deviation)
 tBodyGyro-std()-Z              : Time Domain Signal of Angular Velocity in Z axis (Standard Deviation)
 tBodyGyroJerk-mean()-X         : Time Derived (Jerk) Angular Velocity in X axis (Mean)
 tBodyGyroJerk-mean()-Y         : Time Derived (Jerk) Angular Velocity in Y axis (Mean)
 tBodyGyroJerk-mean()-Z         : Time Derived (Jerk) Angular Velocity in Z axis (Mean)
 tBodyGyroJerk-std()-X          : Time Derived (Jerk) Angular Velocity in X axis (Standard Deviation)
 tBodyGyroJerk-std()-Y          : Time Derived (Jerk) Angular Velocity in Y axis (Standard Deviation)
 tBodyGyroJerk-std()-Z          : Time Derived (Jerk) Angular Velocity in Z axis (Standard Deviation)
 tBodyAccMag-mean()             : 3-Dimensional Euclidian Norm Body Accelation Magnitude (Mean)
 tBodyAccMag-std()              : 3-Dimensional Euclidian Norm Body Accelation Magnitude (Standard Deviation)
 tGravityAccMag-mean()          : 3-Dimensional Euclidian Norm Gravitational Accelation Magnitude (Mean)
 tGravityAccMag-std()           : 3-Dimensional Euclidian Norm Gravitational Accelation Magnitude (Standard Deviation)
 tBodyAccJerkMag-mean()         : 3-Dimensional Euclidian Norm Time-Derived Body Accelation Magnitude (Mean)
 tBodyAccJerkMag-std()          : 3-Dimensional Euclidian Norm Time-Derived Body Accelation Magnitude (Standard Deviation)
 tBodyGyroMag-mean()            : 3-Dimensional Euclidian Norm Angular Velocity Accelation Magnitude (Mean)
 tBodyGyroMag-std()             : 3-Dimensional Euclidian Norm Angular Velocity Accelation Magnitude (Standard Deviation)
 tBodyGyroJerkMag-mean()        : 3-Dimensional Euclidian Norm Time-Derived Angular Velocity Accelation Magnitude (Mean)
 tBodyGyroJerkMag-std()         : 3-Dimensional Euclidian Norm Time-Derived Angular Velocity Accelation Magnitude (Standard Deviation)
 fBodyAcc-mean()-X              : Frequency Domain Signal of Body Accelation in X axis (Mean)
 fBodyAcc-mean()-Y              : Frequency Domain Signal of Body Accelation in Y axis (Mean)
 fBodyAcc-mean()-Z              : Frequency Domain Signal of Body Accelation in Z axis (Mean)
 fBodyAcc-std()-X               : Frequency Domain Signal of Body Accelation in X axis (Standard Deviation)
 fBodyAcc-std()-Y               : Frequency Domain Signal of Body Accelation in Y axis (Standard Deviation)
 fBodyAcc-std()-Z               : Frequency Domain Signal of Body Accelation in Z axis (Standard Deviation)
 fBodyAcc-meanFreq()-X          : Frequency Domain Signal of Body Accelation in X axis (Weighted Average)
 fBodyAcc-meanFreq()-Y          : Frequency Domain Signal of Body Accelation in Y axis (Weighted Average)
 fBodyAcc-meanFreq()-Z          : Frequency Domain Signal of Body Accelation in Z axis (Weighted Average)
 fBodyAccJerk-mean()-X          : Time Derived (Jerk) FFT Body Acceleration in X axis (Mean)
 fBodyAccJerk-mean()-Y          : Time Derived (Jerk) FFT Body Acceleration in Y axis (Mean)
 fBodyAccJerk-mean()-Z          : Time Derived (Jerk) FFT Body Acceleration in Z axis (Mean)
 fBodyAccJerk-std()-X           : Time Derived (Jerk) FFT Body Acceleration in X axis (Standard Deviation)
 fBodyAccJerk-std()-Y           : Time Derived (Jerk) FFT Body Acceleration in Y axis (Standard Deviation)
 fBodyAccJerk-std()-Z           : Time Derived (Jerk) FFT Body Acceleration in Z axis (Standard Deviation)
 fBodyAccJerk-meanFreq()-X      : Time Derived (Jerk) FFT Body Acceleration in X axis (Weighted Average)
 fBodyAccJerk-meanFreq()-Y      : Time Derived (Jerk) FFT Body Acceleration in Y axis (Weighted Average)
 fBodyAccJerk-meanFreq()-Z      : Time Derived (Jerk) FFT Body Acceleration in Z axis (Weighted Average)
 fBodyGyro-mean()-X             : Frequency Domain Signal of Angular Velocity in X axis (Mean)
 fBodyGyro-mean()-Y             : Frequency Domain Signal of Angular Velocity in Y axis (Mean)
 fBodyGyro-mean()-Z             : Frequency Domain Signal of Angular Velocity in Z axis (Mean)
 fBodyGyro-std()-X              : Frequency Domain Signal of Angular Velocity in X axis (Standard Deviation)
 fBodyGyro-std()-Y              : Frequency Domain Signal of Angular Velocity in Y axis (Standard Deviation)
 fBodyGyro-std()-Z              : Frequency Domain Signal of Angular Velocity in Z axis (Standard Deviation)
 fBodyGyro-meanFreq()-X         : Frequency Domain Signal of Angular Velocity in X axis (Weighted Average)
 fBodyGyro-meanFreq()-Y         : Frequency Domain Signal of Angular Velocity in Y axis (Weighted Average)
 fBodyGyro-meanFreq()-Z         : Frequency Domain Signal of Angular Velocity in Z axis (Weighted Average)
 fBodyAccMag-mean()             : 3-Dimensional Euclidian Norm Body Accelation Magnitude (Mean)
 fBodyAccMag-std()              : 3-Dimensional Euclidian Norm Body Accelation Magnitude (Standard Deviation)
 fBodyAccMag-meanFreq()         : 3-Dimensional Euclidian Norm Body Accelation Magnitude (Weighted Average)
 fBodyBodyAccJerkMag-mean()     : 3-Dimensional Euclidian Norm Time-Derived Body Accelation Magnitude (Mean)
 fBodyBodyAccJerkMag-std()      : 3-Dimensional Euclidian Norm Time-Derived Body Accelation Magnitude (Standard Deviation)
 fBodyBodyAccJerkMag-meanFreq() : 3-Dimensional Euclidian Norm Time-Derived Body Accelation Magnitude (Weighted Average)
 fBodyBodyGyroMag-mean()        : 3-Dimensional Euclidian Norm Angular Accelation Magnitude (Mean)
 fBodyBodyGyroMag-std()         : 3-Dimensional Euclidian Norm Angular Accelation Magnitude (Standard Deviation)
 fBodyBodyGyroMag-meanFreq()    : 3-Dimensional Euclidian Norm Angular Accelation Magnitude (Weighted Average)
 fBodyBodyGyroJerkMag-mean()    : 3-Dimensional Euclidian Norm Time-Derived Angular Accelation Magnitude (Mean)
 fBodyBodyGyroJerkMag-std()     : 3-Dimensional Euclidian Norm Time-Derived Angular Accelation Magnitude (Standard Deviation)
 fBodyBodyGyroJerkMag-meanFreq(): 3-Dimensional Euclidian Norm Time-Derived Angular Accelation Magnitude (Weighted Average)
